8.ox
......o.
ooo.....
........
........
........
..o...o.
.o......
...o.o..
