19.ox
........o........o.
.ooo....o..........
......o..o...o...o.
..o.......o.o......
......oo......oo...
...................
.......o...........
..........o........
...o...o..........o
o........o.....o...
.oo................
....oo........o....
.....o...o..o......
o..................
................o..
................o..
.......o......o....
.................o.
..oo............o..
