10.ox
.o.o.o.o..
..o.oo....
..o..o....
ooo.o...oo
..........
.ooo.o..oo
.oo......o
..o...o...
.o..o..o..
.....o.o.o
