9.ox
..o......
.oo.o.o..
o..o.o...
..ooo...o
ooooooo..
.oo..o..o
...o.o..o
.o...o...
....oo...
