14.ox
..............
...oo..o..o...
..............
.......o.....o
.....oo.......
o.o.....o.oo..
o.............
........o.....
....o.....o...
o..o...o.o...o
...o..oo...o..
.......oo..o..
.o.......o..o.
.oo...........
